111111
1C1111
1C0E11
1PC0C1
111111