111111111111111111111
1CCCCCCCCCCCCCCCCCCC1
1C11CCCCCCCCCCCCC11C1
1C111CCCC111CCCC111C1
1C101CCCC101CCCC101C1
1C1011CCC111CCC1101C1
1C1011CCCC1CCCC1101C1
1C10011CCC1CCC11001C1
1C10011CCC1CCC11001C1
1C1001CCCC1CCCC1001C1
1C1011CCC111CCC1001C1
1C1011CC10101CC1101C1
1C1011CCC111CCC1101C1
1C111CCCCC1CCCCC111C1
1C1011CCC111CCC1101C1
1C10011C11011C11001C1
1C10001110001110001C1
1C11111111111111111C1
1PCCCCCCCCCCCCCCCCCE1
111111111111111111111